{

  "level1": [
    99, 99, 99, 99, 99, 99, 99, 99, 99, 99, 99, 99, 99, 99, 99, 99, 99, 99, 99, 99,
    99, 99, 99, 99, 99, 99, 99, 99, 99, 99, 99, 99, 99, 99, 99, 99, 99, 99, 99, 99,
    99, 99, 99, 99, 99, 99, 99, 99, 99, 99, 99, 99, 99, 99, 99, 99, 99, 99, 99, 32,
    99, 99, 99, 99, 99, 99, 99, 99, 99, 99, 99, 99, 99, 99, 34, 34, 34, 34, 34, 34,
    99, 99, 99, 99, 99, 99, 99, 99, 99, 99, 99, 99, 99, 99, 99, 99, 99, 99, 99, 11,
    99, 99, 99, 99, 99, 99, 99, 99, 99, 99, 99, 99, 99, 99, 99, 99, 99, 99, 99, 11,
    22, 99, 99, 99, 99, 99, 99, 99, 99, 99, 99, 99, 99, 21, 12, 12, 12, 12, 12, 21,
    12, 22, 99, 99, 99, 99, 99, 99, 99, 99, 99, 99, 21, 11, 99, 99, 99, 99, 99, 99,
    99, 51, 99, 99, 99, 99, 99, 99, 99, 99, 99, 34, 34, 14, 14, 14, 14, 23, 99, 99,
    99, 99, 22, 99, 99, 99, 99, 99, 99, 99, 99, 99, 99, 99, 99, 99, 99, 99, 99, 99,
    99, 99, 13, 99, 99, 99, 99, 99, 41, 99, 99, 99, 99, 99, 99, 99, 99, 99, 99, 99,
    99, 99, 23, 99, 99, 99, 99, 99, 99, 99, 99, 99, 99, 99, 99, 99, 99, 99, 99, 99,
    99, 99, 99, 99, 99, 99, 99, 99, 99, 99, 99, 99, 99, 99, 99, 99, 99, 99, 99, 99,
    99, 99, 99, 99, 99, 99, 99, 99, 99, 99, 99, 99, 99, 99, 34, 34, 33, 99, 99, 99,
    99, 99, 99, 99, 99, 99, 99, 99, 99, 99, 99, 99, 99, 99, 99, 99, 99, 99, 99, 99,
    99, 99, 99, 99, 99, 99, 99, 99, 99, 99, 99, 99, 99, 99, 99, 99, 99, 99, 99, 99,
    99, 99, 99, 99, 99, 99, 99, 99, 99, 99, 99, 99, 99, 99, 99, 99, 99, 99, 99, 34,
    99, 99, 99, 99, 99, 21, 12, 22, 99, 99, 99, 99, 21, 22, 99, 99, 99, 99, 99, 99,
    99, 99, 99, 99, 99, 11, 99, 13, 99, 99, 99, 99, 11, 13, 99, 99, 99, 99, 99, 99,
    12, 12, 12, 12, 12, 99, 99, 99, 99, 99, 99, 99, 99, 99, 12, 12, 12, 12, 12, 12],



  "levelold": [
    99, 99, 99, 99, 99, 99, 99, 99, 99, 99, 99, 99, 99, 99, 99, 99, 99, 99, 99, 99,
    99, 99, 99, 99, 99, 99, 99, 99, 99, 99, 99, 99, 99, 99, 99, 99, 99, 99, 99, 99,
    99, 99, 99, 99, 99, 99, 99, 99, 99, 99, 99, 99, 99, 99, 99, 99, 99, 99, 99, 99,
    99, 99, 99, 99, 99, 99, 99, 99, 99, 99, 99, 99, 99, 99, 99, 99, 99, 99, 99, 99,
    99, 99, 99, 99, 99, 99, 99, 99, 99, 99, 99, 99, 99, 99, 99, 99, 99, 99, 99, 99,
    99, 99, 99, 99, 99, 99, 99, 99, 99, 99, 99, 99, 99, 99, 99, 99, 99, 99, 99, 99,
    99, 99, 99, 99, 99, 99, 99, 99, 99, 99, 99, 99, 99, 99, 99, 99, 99, 99, 99, 99,
    99, 99, 99, 99, 99, 99, 99, 99, 99, 99, 99, 99, 99, 99, 99, 99, 99, 99, 99, 99,
    99, 99, 99, 99, 99, 99, 99, 99, 99, 99, 99, 99, 99, 99, 99, 99, 99, 99, 99, 99,
    99, 99, 99, 99, 99, 99, 99, 99, 99, 99, 99, 99, 99, 99, 99, 99, 99, 99, 99, 99,
    99, 99, 99, 99, 99, 99, 99, 99, 99, 99, 99, 99, 99, 99, 99, 99, 99, 99, 99, 99,
    99, 99, 99, 99, 99, 99, 99, 99, 99, 99, 99, 99, 99, 99, 99, 99, 99, 99, 99, 99,
    99, 99, 99, 99, 99, 99, 99, 99, 99, 99, 99, 99, 99, 99, 99, 53, 99, 99, 99, 99,
    99, 99, 99, 51, 99, 99, 99, 99, 99, 99, 99, 99, 99, 99, 99, 53, 99, 99, 53, 99,
    99, 53, 99, 99, 99, 99, 99, 99, 53, 99, 99, 53, 99, 99, 99, 99, 99, 99, 99, 99,
    99, 99, 99, 99, 99, 99, 99, 99, 99, 99, 99, 99, 99, 99, 99, 53, 99, 99, 99, 51,
    99, 99, 99, 99, 53, 99, 99, 99, 99, 99, 99, 41, 99, 99, 99, 99, 99, 21, 12, 99,
    99, 99, 99, 99, 23, 99, 99, 99, 99, 99, 99, 99, 99, 99, 99, 21, 12, 99, 99, 99,
    99, 99, 99, 21, 41, 12, 12, 12, 12, 12, 12, 12, 12, 12, 12, 21, 99, 99, 99, 99,
    12, 12, 12, 99, 99, 12, 12, 12, 12, 12, 12, 12, 12, 12, 12, 21, 99, 99, 99, 99
  ],
  "level2": [
    99,99,99,99,99,99,99,99,99,99,99,99,99,99,99,99,99,99,99,99,
    99,99,99,99,99,99,99,99,99,99,99,99,99,99,99,99,99,99,99,99,
    99,99,99,99,99,99,99,99,99,99,99,99,99,99,99,99,99,99,99,99,
    99,99,99,99,99,99,99,99,99,99,99,99,99,99,99,99,99,99,99,99,
    99,99,99,99,99,99,99,99,99,99,99,99,99,99,99,99,99,99,99,99,
    22,99,99,99,99,99,99,99,99,99,99,99,99,99,99,99,99,99,99,99,
    12,22,99,99,99,99,99,99,99,99,99,99,99,99,99,99,99,99,99,99,
    99,51,99,99,99,99,99,99,99,99,99,99,99,99,99,99,99,99,99,99,
    99,22,22,99,99,99,99,99,99,99,99,99,99,99,99,99,99,99,99,99,
    99,99,13,99,99,99,99,99,99,99,99,99,99,99,21,12,22,99,99,99,
    14,14,14,14,14,14,14,14,14,14,14,14,14,14,14,14,23,99,99,99,
    99,99,99,99,99,99,99,99,99,99,99,99,99,99,99,99,99,99,99,99,
    99,99,99,99,99,99,99,99,99,99,99,99,99,99,99,99,99,99,21,21,
    99,99,99,99,99,99,99,99,99,99,99,99,99,99,99,99,99,99,21,99,
    99,99,99,99,99,99,99,99,99,99,99,99,99,99,99,99,99,41,23,99,
    99,99,99,99,99,99,99,99,99,99,99,99,99,99,99,99,99,99,99,99,
    99,99,99,99,99,99,99,99,34,25,25,25,25,33,99,99,99,99,99,99,
    99,99,99,99,21,22,99,99,99,99,99,99,99,99,99,99,99,99,99,99,
    99,99,99,21,21,22,22,99,99,99,99,99,99,99,99,99,99,99,99,99,
    12,12,12,21,99,99,22,12,12,12,12,12,12,12,12,12,12,12,12,12
  ],
  "level3": [
    99, 99, 99, 99, 99, 99, 99, 99, 99, 99, 99, 99, 99, 99, 99, 99, 99, 99, 99, 99,
    99, 99, 99, 99, 99, 99, 99, 99, 99, 99, 99, 99, 99, 99, 99, 99, 99, 99, 21, 12,
    99, 99, 99, 99, 99, 99, 99, 99, 99, 99, 99, 99, 99, 99, 99, 99, 99, 99, 51, 99,
    99, 99, 99, 99, 99, 41, 99, 99, 99, 99, 99, 99, 99, 99, 99, 99, 99, 34, 25, 99,
    99, 99, 99, 99, 99, 99, 99, 99, 99, 99, 34, 33, 99, 99, 99, 99, 99, 99, 99, 99,
    99, 99, 99, 99, 99, 99, 99, 99, 99, 99, 99, 99, 34, 33, 99, 99, 99, 99, 99, 99,
    99, 99, 99, 99, 34, 25, 33, 99, 99, 99, 99, 99, 99, 99, 99, 99, 99, 99, 99, 99,
    22, 22, 99, 99, 99, 99, 99, 99, 99, 99, 99, 99, 99, 99, 99, 99, 99, 99, 99, 99,
    14, 23, 99, 99, 99, 99, 99, 99, 99, 99, 99, 99, 99, 99, 99, 99, 99, 99, 99, 99,
    99, 99, 41, 99, 99, 99, 99, 99, 99, 99, 99, 99, 99, 99, 99, 99, 99, 99, 99, 99,
    99, 99, 99, 41, 99, 99, 99, 99, 99, 99, 99, 99, 99, 99, 99, 99, 99, 99, 99, 99,
    99, 99, 99, 99, 99, 99, 99, 99, 99, 34, 25, 25, 25, 25, 25, 33, 99, 99, 99, 99,
    99, 99, 99, 99, 99, 99, 99, 99, 99, 99, 99, 99, 99, 99, 99, 99, 99, 99, 99, 99,
    99, 99, 99, 99, 99, 99, 99, 99, 99, 99, 99, 99, 99, 99, 99, 99, 99, 32, 99, 99,
    99, 99, 99, 99, 99, 99, 99, 99, 99, 99, 99, 99, 99, 99, 99, 99, 99, 31, 99, 99,
    99, 99, 99, 99, 99, 99, 99, 99, 99, 99, 41, 99, 41, 99, 21, 12, 12, 12, 12, 12,
    99, 99, 99, 99, 99, 99, 21, 12, 22, 99, 99, 99, 99, 99, 21, 99, 99, 99, 99, 99,
    99, 99, 99, 99, 99, 21, 21, 99, 22, 99, 99, 99, 99, 99, 21, 99, 99, 99, 99, 99,
    99, 99, 99, 99, 21, 21, 99, 99, 99, 99, 99, 99, 99, 99, 99, 99, 99, 99, 99, 99,
    12, 12, 12, 12, 21, 99, 99, 99, 99, 99, 99, 99, 99, 99, 99, 99, 99, 99, 99, 99
  ]
}