{
  "level1": [
    14, 99, 14, 14, 14, 14, 14, 14, 14, 14, 14, 14, 14, 14, 14, 14, 14, 14, 14, 99,
    13, 99, 99, 99, 99, 99, 99, 99, 99, 99, 99, 99, 99, 99, 99, 99, 99, 99, 99, 11,
    13, 99, 99, 99, 99, 99, 99, 99, 99, 99, 99, 99, 99, 99, 99, 99, 99, 99, 99, 11,
    13, 99, 99, 99, 99, 99, 99, 99, 99, 99, 99, 99, 99, 99, 99, 99, 99, 99, 99, 11,
    13, 99, 99, 99, 99, 99, 99, 99, 99, 99, 99, 99, 99, 99, 99, 99, 99, 99, 99, 11,
    13, 99, 99, 99, 99, 99, 99, 99, 99, 99, 99, 99, 99, 99, 99, 99, 99, 99, 99, 11,
    13, 99, 99, 99, 99, 99, 99, 99, 99, 99, 99, 99, 99, 99, 99, 99, 99, 99, 99, 11,
    13, 99, 99, 99, 99, 99, 99, 99, 99, 99, 99, 99, 99, 99, 99, 99, 99, 99, 99, 11,
    13, 99, 99, 99, 99, 99, 99, 99, 99, 99, 99, 99, 99, 99, 99, 99, 99, 99, 99, 11,
    13, 99, 99, 99, 99, 99, 99, 99, 99, 99, 99, 99, 99, 99, 99, 99, 99, 99, 99, 11,
    13, 99, 99, 99, 99, 99, 99, 99, 99, 99, 99, 99, 99, 99, 99, 99, 99, 99, 99, 11,
    13, 99, 99, 99, 99, 99, 99, 99, 99, 99, 99, 99, 99, 99, 99, 99, 99, 99, 99, 11,
    13, 99, 99, 99, 99, 99, 99, 99, 99, 99, 99, 99, 99, 99, 99, 53, 99, 99, 99, 11,
    13, 99, 99, 99, 99, 99, 99, 99, 99, 99, 99, 99, 99, 99, 99, 53, 99, 99, 53, 11,
    13, 53, 99, 99, 99, 99, 99, 99, 53, 99, 99, 53, 99, 99, 99, 99, 99, 99, 99, 11,
    13, 99, 99, 99, 99, 99, 99, 99, 99, 99, 99, 99, 99, 99, 99, 53, 99, 99, 51, 11,
    13, 99, 99, 99, 53, 99, 99, 99, 99, 99, 99, 41, 99, 99, 99, 99, 99, 21, 12, 99,
    13, 99, 99, 99, 23, 99, 99, 99, 99, 99, 99, 99, 99, 99, 99, 21, 12, 99, 99, 99,
    13, 99, 99, 21, 41, 12, 12, 12, 12, 12, 12, 12, 12, 12, 12, 21, 99, 99, 99, 99,
    13, 12, 12, 99, 99, 12, 12, 12, 12, 12, 12, 12, 12, 12, 12, 21, 99, 99, 99, 99
  ],
  "level2": [
    99, 14, 14, 14, 14, 14, 14, 14, 14, 14, 14, 14, 14, 14, 14, 14, 14, 14, 14, 99,
    13, 99, 99, 99, 99, 99, 99, 99, 99, 99, 99, 99, 99, 99, 99, 99, 99, 99, 99, 11,
    13, 99, 99, 99, 99, 99, 99, 99, 99, 99, 99, 99, 99, 99, 99, 99, 99, 99, 99, 11,
    13, 99, 99, 99, 99, 99, 99, 99, 99, 99, 99, 99, 99, 99, 99, 99, 99, 99, 99, 11,
    13, 99, 99, 99, 99, 99, 99, 99, 99, 99, 99, 99, 99, 99, 99, 99, 99, 99, 99, 11,
    13, 99, 99, 99, 99, 99, 99, 99, 99, 99, 99, 99, 99, 99, 99, 99, 99, 99, 99, 11,
    13, 99, 99, 99, 99, 99, 99, 99, 99, 99, 99, 99, 99, 99, 99, 99, 99, 99, 99, 11,
    13, 99, 99, 99, 99, 99, 99, 99, 99, 99, 99, 99, 99, 99, 99, 99, 99, 99, 99, 11,
    13, 99, 99, 99, 99, 99, 99, 99, 99, 99, 99, 99, 99, 99, 99, 99, 99, 99, 99, 11,
    13, 99, 99, 99, 99, 99, 99, 99, 99, 99, 99, 99, 99, 99, 53, 99, 53, 99, 51, 11,
    13, 99, 99, 99, 99, 99, 99, 99, 99, 99, 99, 99, 21, 12, 12, 12, 12, 12, 12, 21,
    13, 99, 99, 99, 99, 99, 99, 99, 99, 99, 99, 99, 11, 99, 99, 99, 99, 99, 99, 99,
    13, 99, 99, 99, 99, 99, 99, 99, 99, 99, 99, 99, 11, 99, 99, 99, 99, 99, 99, 99,
    13, 99, 99, 99, 99, 99, 99, 99, 99, 99, 99, 99, 11, 99, 99, 99, 99, 99, 99, 99,
    13, 99, 99, 99, 99, 99, 99, 99, 41, 99, 99, 99, 31, 14, 14, 14, 31, 99, 99, 99,
    13, 99, 99, 99, 99, 99, 99, 99, 99, 99, 99, 99, 99, 99, 99, 99, 11, 99, 99, 99,
    13, 99, 99, 99, 99, 99, 99, 99, 99, 99, 99, 99, 99, 99, 53, 53, 11, 99, 99, 99,
    13, 99, 99, 99, 23, 99, 99, 99, 99, 99, 99, 99, 21, 12, 12, 12, 21, 99, 99, 99,
    13, 99, 99, 21, 13, 99, 54, 99, 23, 99, 54, 99, 11, 99, 99, 99, 99, 99, 99, 99,
    13, 12, 12, 21, 22, 12, 12, 12, 23, 12, 12, 12, 21, 99, 99, 99, 99, 99, 99, 99
  ],
  "level3": [
    99, 14, 14, 14, 14, 14, 14, 14, 14, 14, 14, 14, 14, 14, 14, 14, 14, 14, 14, 99,
    13, 99, 99, 99, 99, 99, 99, 99, 99, 99, 99, 99, 99, 99, 99, 99, 99, 99, 99, 11,
    13, 99, 99, 99, 99, 99, 99, 99, 99, 99, 99, 99, 99, 99, 99, 99, 99, 99, 99, 11,
    13, 99, 99, 99, 99, 99, 99, 99, 99, 99, 99, 99, 99, 99, 99, 99, 99, 99, 99, 11,
    13, 99, 99, 99, 99, 99, 99, 99, 99, 99, 99, 99, 99, 99, 99, 99, 99, 99, 99, 11,
    13, 99, 99, 99, 99, 99, 99, 99, 99, 99, 99, 99, 99, 99, 99, 99, 99, 99, 99, 11,
    13, 99, 99, 99, 99, 99, 99, 99, 99, 99, 99, 99, 99, 99, 99, 99, 99, 99, 99, 11,
    13, 99, 99, 99, 99, 99, 53, 99, 99, 99, 53, 99, 99, 99, 99, 99, 99, 99, 99, 11,
    13, 51, 99, 99, 99, 99, 99, 99, 99, 99, 99, 99, 99, 99, 99, 53, 99, 99, 99, 11,
    13, 22, 99, 99, 99, 99, 99, 99, 99, 99, 99, 99, 99, 99, 99, 41, 99, 99, 99, 11,
    13, 13, 99, 99, 99, 99, 99, 99, 99, 99, 99, 99, 99, 99, 99, 99, 99, 99, 99, 11,
    13, 22, 99, 99, 99, 99, 99, 99, 99, 99, 99, 99, 99, 99, 99, 99, 99, 99, 99, 11,
    13, 99, 99, 99, 99, 99, 99, 99, 99, 99, 99, 99, 99, 99, 99, 99, 99, 99, 99, 11,
    13, 99, 99, 99, 99, 99, 99, 99, 99, 99, 99, 99, 99, 53, 99, 99, 99, 99, 99, 11,
    13, 99, 99, 99, 99, 99, 99, 99, 99, 99, 99, 99, 21, 12, 22, 99, 99, 99, 99, 11,
    13, 99, 99, 99, 99, 99, 99, 99, 99, 99, 99, 99, 31, 14, 32, 99, 53, 99, 99, 11,
    13, 99, 99, 99, 99, 99, 99, 99, 99, 99, 99, 99, 99, 99, 99, 99, 41, 99, 99, 11,
    13, 99, 99, 99, 99, 99, 99, 99, 99, 99, 99, 99, 99, 99, 99, 99, 99, 99, 99, 11,
    13, 99, 99, 99, 21, 22, 99, 99, 99, 99, 41, 99, 53, 53, 99, 99, 99, 54, 99, 11,
    13, 12, 12, 12, 12, 22, 12, 12, 12, 12, 23, 12, 12, 12, 12, 12, 12, 12, 12, 11
  ]
}