0,0,0,0,0,0,0,0,0,0,0,0,0,0,0,0,0,0,0,0
0,#,#,#,#,#,#,#,#,#,#,#,#,#,#,#,#,#,#,0
0,#,#,#,#,#,#,#,#,#,#,#,#,#,#,#,#,#,#,0
0,#,#,#,#,#,#,#,#,#,#,#,#,#,#,#,#,#,#,0
0,#,#,#,#,#,#,#,#,#,#,#,#,#,#,#,#,#,#,0
0,#,#,#,#,#,#,#,#,#,#,#,#,#,#,#,#,#,#,0
0,#,#,#,#,#,#,#,#,#,#,#,#,#,#,#,#,#,#,0
0,#,#,#,#,#,#,#,#,#,#,#,#,#,#,#,#,#,#,0
0,#,#,#,#,#,#,#,#,#,#,#,#,#,#,#,#,#,#,0
0,#,#,#,#,#,#,#,#,#,#,#,#,#,#,#,#,#,#,0
0,#,#,#,#,#,#,#,#,#,#,#,#,#,#,#,#,#,#,0
0,#,#,#,#,#,#,#,#,#,#,#,#,#,#,#,#,#,#,0
0,#,#,#,#,#,#,#,#,#,#,#,#,#,#,6,#,#,#,0
0,#,#,#,#,#,#,#,#,#,#,#,#,#,#,6,#,#,6,0
0,6,#,#,#,#,#,#,6,#,#,6,#,#,#,#,#,#,#,0
0,#,#,#,#,#,#,#,#,#,#,#,#,#,#,6,#,#,7,0
0,#,#,#,#,#,#,#,3,#,#,1,#,#,#,#,#,1,1,0
0,#,#,#,1,5,5,5,5,5,5,5,5,5,5,1,1,0,0,0
0,#,#,1,0,0,0,0,0,0,0,0,0,0,0,0,0,0,0,0
0,1,1,0,0,0,0,0,0,0,0,0,0,0,0,0,0,0,0,0
